10 10
B . . . . . O O O .     
. . . . . . O O O .     
. . . . R O O O R .
. . . R O O O O R .
. H . O O O O R . .
. . . R O O R . . .
. . . . . . . . . .
. . . H R R . . . .
. . . H R R . . . .
. . . . H . . . . .
